+--+--+--+--+
|     |     |
+  +--+  +--+
|        |  |
+  +  +--+  +
|  |        |
+--++--+-  -+
|g          |
+--+--+--+--+